 1111111111111111111
 1223322232232332221
 1222222123232222221
 1222222333222123221
 1333322233322313321
 1233323123322323121
 1223322312223332221
 1111222121331113311
 1223332223222223111
 1223213333233211111
 1311111223223333331
 1322332213222222321
 1222113212132111121
 1332222222132222221
 1223213333233211111
 1311111223223333331
 1222332213222222321
 1111111111111111111
