 1111111111111111111
 1222223323222313231
 1222222123232222331
 1222222333222123221
 1222223123133313321
 1233323123322323121
 1223322312223332221
 1111222121331113311
 1223332223222223111
 1212233333132233221
 1333322222222223321
 1212311113132233331
 1222113212132111121
 1332222222132222221
 1223213333233211111
 1311111223223333331
 1222332213222222321
 1111111111111111111
